1111111111111111
10010000000C0001
1E00011000100001
1100C11000100001
1P00010110C00001
1100100111000001
10010100000C0001
1000011000110001
1000C10000100001
1110000110C00011
1000100111000101
1111111111111111